68
21
586 586 586 586 586 586 586 586 586 586 586 586 586 586 586 586 586 586 586 586 586 586 586 586 586 586 586 586 586 586 586 586 586 586 586 586 586 586 586 586 586 586 586 586 586 586 586 586 586 586 586 586 586 586 586 586 586 586 586 586 586 586 586 586 586 586 586 586 
586 586 586 586 586 586 586 586 586 586 586 586 586 586 586 586 586 586 586 586 586 586 586 586 586 586 586 586 586 586 586 586 586 586 429 425 426 427 428 429 425 426 427 428 429 425 426 427 428 429 425 426 427 428 429 425 426 427 428 429 425 426 427 426 586 586 586 586 
586 586 586 586 586 586 586 586 586 586 586 586 586 586 586 586 586 586 586 586 586 586 586 586 586 586 586 586 586 586 586 586 586 451 452 448 449 450 451 452 448 449 450 451 452 448 449 450 451 452 448 449 450 451 452 448 449 450 451 452 448 449 450 451 452 586 586 586 
586 586 586 586 586 586 586 586 586 586 586 586 586 586 586 586 586 586 586 586 586 586 586 586 586 586 586 586 586 586 586 586 473 474 475 471 472 473 474 475 471 472 473 474 475 471 472 473 474 475 471 472 473 474 475 471 472 473 474 475 471 472 473 474 475 471 586 586 
586 586 586 586 586 586 586 586 586 586 586 586 586 586 586 586 586 586 586 586 586 586 586 586 586 586 586 586 586 586 586 495 496 497 498 494 495 496 497 498 494 495 496 497 498 494 495 496 497 498 494 495 496 497 498 494 495 496 497 498 494 495 496 497 498 494 495 586 
586 586 586 586 586 586 586 586 586 586 586 586 586 586 586 586 586 586 586 586 586 586 586 586 586 586 586 586 586 586 586 403 404 405 406 402 403 404 405 406 402 403 404 405 406 402 403 404 405 406 402 403 404 405 406 402 403 404 405 406 402 403 404 405 406 402 403 586 
586 586 586 586 586 586 586 586 586 586 586 586 586 586 586 586 586 586 586 586 586 586 586 586 586 586 586 586 586 586 586 426 427 428 429 425 426 427 428 429 425 426 427 428 429 425 426 427 428 429 425 426 427 428 429 425 426 427 428 429 425 426 427 428 429 425 426 586 
586 586 586 586 586 586 586 586 586 586 586 586 586 586 586 586 586 586 586 586 586 586 586 586 586 586 586 586 586 586 586 449 450 451 452 448 449 450 451 452 448 449 450 451 452 448 449 450 451 452 448 449 450 451 452 448 449 450 451 452 448 449 450 451 452 448 449 586 
586 586 586 586 586 586 586 586 586 586 586 586 586 586 586 586 586 586 586 586 586 586 586 586 586 586 586 586 586 586 586 472 473 474 475 471 472 473 474 475 471 472 473 474 475 471 472 473 474 475 471 472 473 474 475 471 472 473 474 475 471 472 473 474 475 471 472 586 
586 586 586 586 586 586 586 586 586 586 586 586 586 586 586 586 586 586 586 586 586 586 586 586 586 586 586 586 586 586 586 495 496 497 591 592 593 585 497 498 494 495 496 497 498 494 495 496 497 498 494 495 496 497 498 494 495 496 497 498 494 495 591 592 593 585 495 586 
586 586 586 586 586 586 586 586 586 586 586 586 586 586 586 586 586 586 586 586 586 586 586 586 586 586 586 586 586 586 586 403 404 405 406 402 403 404 405 406 402 403 404 405 406 402 403 404 405 406 402 403 404 405 406 402 403 404 405 406 402 403 404 405 406 402 403 586 
586 586 586 586 586 586 586 586 586 586 586 586 586 586 586 586 586 586 586 586 586 586 586 586 586 586 586 586 586 586 586 426 427 428 429 425 426 427 428 429 425 426 427 428 429 425 426 427 428 429 425 426 427 428 429 425 426 427 428 429 425 426 427 428 429 425 426 586 
586 586 586 586 586 586 586 586 586 586 586 586 586 586 586 586 586 586 586 586 586 586 586 586 586 586 586 586 586 586 586 449 450 451 452 448 449 450 451 452 448 449 450 451 452 448 449 450 451 452 448 449 450 451 452 448 449 450 451 452 448 449 450 451 452 448 449 586 
586 586 586 586 586 586 586 586 586 586 586 586 586 586 586 586 586 586 586 586 586 586 586 586 586 586 586 586 586 586 586 472 473 474 475 471 472 473 474 475 471 472 473 474 475 471 472 473 474 475 471 472 473 474 475 471 472 473 474 475 471 472 473 474 475 471 472 586
586 586 586 586 586 586 586 586 586 586 586 586 586 586 586 586 586 586 586 586 586 586 586 586 586 586 586 586 586 586 586 495 496 497 498 494 495 496 497 498 494 495 591 592 593 585 495 496 497 498 494 495 496 497 591 592 593 585 497 498 494 495 496 497 498 494 495 586
586 586 586 586 498 494 495 496 497 498 494 495 496 497 498 494 495 496 497 498 494 495 496 497 498 494 495 496 497 498 494 403 404 405 406 402 403 404 405 406 402 403 404 405 406 402 403 404 405 406 402 403 404 405 406 402 403 404 405 406 402 403 404 405 406 402 403 586
586 586 586 405 406 402 403 404 405 406 402 403 404 405 406 402 403 404 405 406 402 403 404 405 406 402 403 404 405 406 402 426 427 428 429 425 426 427 428 429 425 426 427 428 429 425 426 427 428 429 425 426 427 428 429 425 426 427 428 429 425 426 427 428 429 425 426 586
586 586 427 428 429 425 426 427 428 429 425 426 427 428 429 425 426 427 428 429 425 426 427 428 429 425 426 427 428 429 425 449 450 451 452 448 449 450 451 452 448 449 450 451 452 448 449 450 451 452 448 449 450 451 452 448 449 450 451 452 448 449 450 451 452 448 449 586
586 586 586 451 452 448 449 450 451 452 448 449 450 451 452 448 449 450 451 452 448 449 450 451 452 448 449 450 451 452 448 472 473 474 475 471 472 473 474 475 471 472 473 474 475 471 472 473 474 475 471 472 473 474 475 471 472 473 474 475 471 472 473 474 475 471 472 586
586 586 586 586 472 471 472 473 474 475 471 472 473 474 475 471 472 473 474 475 471 472 473 474 475 471 472 473 474 475 471 472 471 472 473 474 475 471 472 473 474 475 471 472 473 474 475 471 472 473 474 475 471 472 473 474 475 471 472 471 472 473 474 475 471 472 473 586
586 586 586 586 586 586 586 586 586 586 586 586 586 586 586 586 586 586 586 586 586 586 586 586 586 586 586 586 586 586 586 586 586 586 586 586 586 586 586 586 586 586 586 586 586 586 586 586 586 586 586 586 586 586 586 586 586 586 586 586 586 586 586 586 586 586 586 586